1111111111111
1X010000000X1
1000011111001
1P0X11100X0C1
10001E0000001
1111111111111