1111111111111111111111111111111111
1E0000000000000C000X0C0000000000X1
10100101001000001010010X0000010101
1010X1001010101X001001000X00010101
1P00000X0C00C00000000000000X0000C1
1111111111111111111111111111111111