1111111111111111111111
1010001111101110101111
1X101011100C1111111011
10X0000P00E00000X01111
1111111111111111111111